1111111
100CC01
1P11001
10100C1


10C0001
1E00101
1111111
